11111111111
1000C000001
10000000C01
10011110001
10001P00001
10E01000C01
10000010001
10000C00001
11111111111
