11111111111111111111111111
110000000C110000000C000001
100C000000100C0010000C0001
1101011111100010000C000001
1000100001P000110000011111
110C00E001011100C0000C0001
100000CC000100CC0000001111
1000000C00110000C000000001
11111111111111111111111111
