11111111111111111111111111
1100000000100110000C001101
100111111000111C1000100001
11001111000111111000C01101
10011110001111111000111001
110011000000000000011C1101
1C011000111C11100010001001
11001000111100100110111101
10011000000000100110C11001
110C10000E0C00C0P000000101
10011111011000111111111C01
11C00111C11000111000011101
11111111111111111111111111