11111111111111111111111111
1E0011100000C0001110C00101
10001000C00001C00C00110011
10C0100000001C1C0000001001
100010000C0000111000011C11
10C010000000C1000000001101
1000100000C001C11000011011
10C01000000011C00000001001
1000000C00000011000C0010P1
10000110000000001100000011
110C0110000011111C00000111
11111111111111111111111111