111111
10C001
1000E1
10C001
10P001
111111