111111
10C0E1
100011
10C001
10P001
111111